{
id: MAP
map: [
	[
		[ 16, 16, 16, 16, 16, 16, 16, 16, 16, 16, 16, 16, 16, 16, 16, 16, 16, 16, 16, 16, 16, 16, 16, 16, 16 ]
		[ 16, 16, 16, 16, 16, 16, 16, 16, 16, 16, 16, 16, 16, 16, 16, 16, 16, 16, 16, 16, 16, 16, 16, 16, 16 ]
		[ 16, 16, 11, 5, 5, 5, 18, 5, 5, 5, 5, 12, 16, 9, 16, 16, 9, 16, 11, 5, 18, 5, 12, 16, 16 ]
		[ 16, 16, 3, 1, 1, 6, 22, 3, 1, 1, 1, 1, 5, 4, 5, 5, 1, 5, 1, 6, 22, 3, 6, 16, 16 ]
		[ 16, 16, 13, 1, 1, 1, 18, 1, 1, 1, 1, 4, 6, 22, 3, 1, 1, 4, 4, 1, 5, 4, 6, 16, 16 ]
		[ 16, 16, 21, 3, 1, 6, 22, 3, 4, 1, 6, 22, 3, 5, 1, 1, 14, 22, 22, 13, 6, 22, 17, 16, 16 ]
		[ 16, 16, 16, 3, 1, 1, 5, 6, 22, 3, 1, 5, 1, 1, 1, 6, 22, 11, 12, 22, 3, 5, 14, 16, 16 ]
		[ 16, 16, 11, 1, 1, 1, 1, 4, 5, 1, 1, 1, 1, 1, 4, 1, 5, 4, 1, 18, 1, 6, 23, 16, 16 ]
		[ 16, 16, 3, 1, 1, 1, 14, 22, 3, 1, 1, 1, 1, 6, 22, 3, 6, 22, 17, 22, 13, 1, 12, 16, 16 ]
		[ 16, 16, 3, 1, 1, 6, 23, 16, 3, 4, 1, 1, 1, 4, 5, 1, 1, 5, 1, 12, 22, 3, 6, 16, 16 ]
		[ 16, 16, 13, 1, 1, 1, 18, 5, 14, 22, 3, 1, 6, 22, 3, 1, 1, 1, 4, 1, 5, 4, 6, 16, 16 ]
		[ 16, 16, 21, 3, 1, 6, 22, 8, 22, 10, 1, 1, 1, 5, 1, 1, 1, 6, 22, 3, 6, 22, 17, 16, 16 ]
		[ 16, 16, 11, 1, 1, 14, 16, 20, 9, 22, 13, 1, 1, 1, 4, 1, 1, 4, 5, 1, 6, 16, 17, 16, 16 ]
		[ 16, 16, 3, 1, 6, 23, 16, 11, 6, 16, 21, 3, 1, 6, 22, 3, 6, 22, 3, 1, 1, 18, 6, 16, 16 ]
		[ 16, 16, 3, 1, 4, 5, 5, 1, 1, 18, 5, 1, 1, 1, 5, 4, 1, 5, 1, 1, 6, 22, 8, 16, 16 ]
		[ 16, 16, 13, 6, 22, 13, 1, 1, 6, 22, 3, 4, 4, 1, 6, 22, 13, 1, 1, 1, 4, 15, 20, 16, 16 ]
		[ 16, 16, 21, 3, 12, 22, 3, 1, 1, 5, 6, 22, 22, 13, 4, 12, 22, 13, 1, 14, 22, 22, 9, 16, 16 ]
		[ 16, 16, 11, 4, 4, 5, 1, 1, 4, 1, 1, 5, 12, 22, 22, 3, 12, 22, 17, 23, 16, 16, 17, 16, 16 ]
		[ 16, 16, 17, 22, 22, 3, 1, 6, 22, 3, 1, 1, 1, 5, 5, 1, 6, 16, 3, 5, 5, 18, 6, 16, 16 ]
		[ 16, 16, 13, 5, 5, 4, 1, 6, 16, 3, 1, 4, 1, 1, 1, 1, 1, 18, 1, 4, 14, 22, 17, 16, 16 ]
		[ 16, 16, 21, 3, 14, 22, 3, 6, 16, 13, 6, 22, 3, 1, 1, 1, 6, 22, 8, 22, 23, 16, 17, 16, 16 ]
		[ 16, 16, 11, 14, 22, 11, 1, 14, 16, 21, 3, 5, 1, 1, 1, 4, 4, 12, 20, 11, 12, 16, 17, 16, 16 ]
		[ 16, 16, 8, 23, 16, 13, 14, 22, 10, 18, 4, 4, 4, 4, 14, 22, 22, 13, 18, 4, 4, 18, 14, 16, 16 ]
		[ 16, 16, 20, 16, 16, 21, 23, 16, 21, 22, 22, 22, 22, 22, 23, 16, 16, 21, 22, 22, 22, 22, 23, 16, 16 ]
		[ 16, 16, 16, 16, 16, 16, 16, 16, 16, 16, 16, 16, 16, 16, 16, 16, 16, 16, 16, 16, 16, 16, 16, 16, 16 ]
	]
	[
		[ 0, 0, 0, 0, 0, 0, 0, 0, 0, 0, 0, 0, 0, 0, 0, 0, 0, 0, 0, 0, 0, 0, 0, 0, 0 ]
		[ 0, 0, 0, 0, 0, 0, 0, 0, 0, 0, 0, 0, 0, 0, 0, 0, 0, 0, 0, 0, 0, 0, 0, 0, 0 ]
		[ 0, 0, 0, 0, 0, 0, 0, 0, 0, 0, 0, 0, 0, 0, 0, 0, 0, 0, 0, 0, 0, 0, 0, 0, 0 ]
		[ 0, 0, 0, 0, 0, 0, 0, 0, 0, 0, 0, 0, 0, 0, 0, 0, 0, 0, 0, 0, 0, 0, 0, 0, 0 ]
		[ 0, 0, 0, 0, 0, 0, 0, 0, 0, 0, 0, 0, 0, 0, 0, 0, 0, 0, 0, 0, 0, 0, 0, 0, 0 ]
		[ 0, 0, 0, 0, 0, 0, 0, 0, 0, 0, 0, 0, 0, 0, 0, 0, 0, 0, 0, 0, 0, 0, 0, 0, 0 ]
		[ 0, 0, 0, 0, 0, 0, 0, 0, 0, 0, 0, 0, 0, 0, 0, 0, 0, 0, 0, 0, 0, 0, 0, 0, 0 ]
		[ 0, 0, 0, 0, 0, 0, 0, 0, 0, 0, 0, 0, 0, 0, 0, 0, 0, 0, 0, 0, 0, 0, 0, 0, 0 ]
		[ 0, 0, 0, 0, 0, 0, 0, 0, 0, 0, 0, 0, 0, 0, 0, 0, 0, 0, 0, 0, 0, 0, 0, 0, 0 ]
		[ 0, 0, 0, 0, 0, 0, 0, 0, 0, 0, 0, 0, 0, 0, 0, 0, 0, 0, 0, 0, 0, 0, 0, 0, 0 ]
		[ 0, 0, 0, 0, 0, 0, 0, 0, 0, 0, 0, 0, 0, 0, 0, 0, 0, 0, 0, 0, 0, 0, 0, 0, 0 ]
		[ 0, 0, 0, 0, 0, 0, 0, 0, 0, 0, 0, 0, 0, 0, 0, 0, 0, 0, 0, 0, 0, 0, 0, 0, 0 ]
		[ 0, 0, 0, 0, 0, 0, 0, 0, 0, 0, 0, 0, 0, 0, 0, 0, 0, 0, 0, 0, 0, 0, 0, 0, 0 ]
		[ 0, 0, 0, 0, 0, 0, 0, 0, 0, 0, 0, 0, 0, 0, 0, 0, 0, 0, 0, 0, 0, 0, 0, 0, 0 ]
		[ 0, 0, 0, 0, 0, 0, 0, 0, 0, 0, 0, 0, 0, 0, 0, 0, 0, 0, 0, 0, 0, 0, 0, 0, 0 ]
		[ 0, 0, 0, 0, 0, 0, 0, 0, 0, 0, 0, 0, 0, 0, 0, 0, 0, 0, 0, 0, 0, 0, 0, 0, 0 ]
		[ 0, 0, 0, 0, 0, 0, 0, 0, 0, 0, 0, 0, 0, 0, 0, 0, 0, 0, 0, 0, 0, 0, 0, 0, 0 ]
		[ 0, 0, 0, 0, 0, 0, 0, 0, 0, 0, 0, 0, 0, 0, 0, 0, 0, 0, 0, 0, 0, 0, 0, 0, 0 ]
		[ 0, 0, 0, 0, 0, 0, 0, 0, 0, 0, 0, 0, 0, 0, 0, 0, 0, 0, 0, 0, 0, 0, 0, 0, 0 ]
		[ 0, 0, 0, 0, 0, 0, 0, 0, 0, 0, 0, 0, 0, 0, 0, 0, 0, 0, 0, 0, 0, 0, 0, 0, 0 ]
		[ 0, 0, 0, 0, 0, 0, 0, 0, 0, 0, 0, 0, 0, 0, 0, 0, 0, 0, 0, 0, 0, 0, 0, 0, 0 ]
		[ 0, 0, 0, 0, 0, 0, 0, 0, 0, 0, 0, 0, 0, 0, 0, 0, 0, 0, 0, 0, 0, 0, 0, 0, 0 ]
		[ 0, 0, 0, 0, 0, 0, 0, 0, 0, 0, 0, 0, 0, 0, 0, 0, 0, 0, 0, 0, 0, 0, 0, 0, 0 ]
		[ 0, 0, 0, 0, 0, 0, 0, 0, 0, 0, 0, 0, 0, 0, 0, 0, 0, 0, 0, 0, 0, 0, 0, 0, 0 ]
		[ 0, 0, 0, 0, 0, 0, 0, 0, 0, 0, 0, 0, 0, 0, 0, 0, 0, 0, 0, 0, 0, 0, 0, 0, 0 ]
	]
]
}